1 1 2 3 2 3 2 3 2 3 2 3 1 1 1 1 1 1 2 3 2 3 2 3 2 3 2 3 1 1 1 1 1 1 1 1 1 1 1 1 4 5 6 7 6 7 8 9 
10 11 10 11 10 11 10 11 10 11 10 11 1 1 1 1 10 11 10 11 10 11 10 11 10 11 10 11 1 1 1 1 1 1 1 1 1 1 1 1 9 9 5 12 5 12 13 9 
14 15 14 15 14 15 14 15 14 15 14 15 2 3 2 3 14 15 14 15 14 15 14 15 14 15 14 15 2 3 2 3 2 3 2 3 2 3 2 3 9 16 17 12 17 12 18 9 
10 19 20 21 22 11 10 11 10 11 10 11 10 11 10 11 10 19 20 21 22 11 10 11 10 11 10 11 10 11 10 11 10 11 10 19 20 21 20 23 9 5 24 25 5 12 26 9 
14 27 28 29 30 15 14 15 14 15 14 15 14 15 14 15 14 27 28 29 30 15 14 15 14 15 14 15 14 15 14 15 14 15 14 27 28 29 28 29 9 31 32 9 17 12 8 9 
20 23 9 9 33 21 20 21 20 21 20 21 20 21 20 21 20 23 9 9 33 21 20 21 20 21 20 21 20 21 20 21 20 21 20 23 9 9 9 9 9 5 26 9 5 12 13 9 
28 29 34 35 28 29 28 29 28 29 28 29 28 29 28 29 28 29 34 35 28 29 28 29 28 29 28 29 28 29 28 29 28 29 28 29 34 35 9 9 9 31 8 9 17 12 18 9 
36 37 38 39 9 9 40 37 40 37 9 9 40 37 9 9 40 37 38 39 9 9 40 37 40 37 9 9 40 37 9 9 9 9 9 9 38 39 9 9 9 31 41 9 31 42 13 9 
43 44 45 46 47 48 49 50 49 44 47 48 49 44 47 48 49 44 45 46 47 48 49 50 49 44 47 48 49 44 47 48 48 48 51 52 53 54 55 56 57 58 59 9 59 60 61 9 
62 62 62 62 63 63 62 64 62 62 63 63 62 62 63 63 62 62 62 62 63 63 62 64 62 62 63 63 62 62 63 63 63 63 62 62 62 62 65 62 62 66 65 63 65 62 67 68 
