1, 1, 2, 3, 2, 3, 2, 3, 2, 3, 2, 3, 1, 1, 1, 1, 
1, 1, 2, 3, 2, 3, 2, 3,
2, 3, 2, 3, 1, 1, 1, 1, 1, 1, 1, 1, 1, 1, 1, 1, 
4, 5, 6, 7, 6, 7, 8, 9,
10, 11, 10, 11, 10, 11, 10, 11, 10, 11, 10, 11, 1, 1, 1, 1, 
10, 11, 10, 11, 10, 11, 10, 11,
10, 11, 10, 11, 1, 1, 1, 1, 1, 1, 1, 1, 1, 1, 1, 1, 
9, 9, 12, 13, 12, 13, 14, 9,
15, 16, 15, 16, 15, 16, 15, 16, 15, 16, 15, 16, 2, 3, 2, 3, 
15, 16, 15, 16, 15, 16, 15, 16,
15, 16, 15, 16, 2, 3, 2, 3, 2, 3, 2, 3, 2, 3, 2, 3, 
9, 17, 18, 13, 18, 13, 19, 9